1:1	concept=single
1:n	concept=oneN
aggregate	concept=aggregate
arrange	concept=arrange
dimension	concept=dimension
drag	concept=arrange
drill down	concept=drill-down
drill-down	concept=drill-down
fact	concept=fact
data object	concept=fact
grain	concept=grain
hiearchy	concept=hierarchy
hierarchies	concept=hierarchy
information need	concept=question
measure	concept=measure
numeric	concept=numeric
numerical	concept=numeric
one-to-n	concept=oneN
one to one	concept=single
one-to-one	concept=single
question	concept=question
ask	concept=question
row	concept=row
single	concept=single
single value	concept=single
sum	concept=aggregate
unique	concept=single
parent-child	concept=oneN
parent child	concept = oneN
number	concept=numeric
predict	concept=predict
predictive	concept=predict
classification	concept=classification
classify	concept=classification
classifier	concept=classification
regression	concept=regression
data object	concept=data object
record	concept=data object
instance	concept=data object
feature	concept=feature
attribute	concept=feature
variable	concept=feature
class	concept=class attribute
class attribute	concept=class attribute
target	concept=class attribute
target variable	concept=class attribute
correlate	concept=correlate
insight	concept=insight
understand	concept=insight
explain	concept=insight
explanatory	concept=insight
faster	concept=faster
quicker	concept=faster
better	concept=better
improve	concept=better
improvement	concept=better
avoid	concept=avoid
risk	concept=avoid
