1:1	concept=single
1:n	concept=oneN
aggregate	concept=aggregate
arrange	concept=arrange
dimension	concept=dimension
drag	concept=arrange
drill down	concept=drill-down
drill-down	concept=drill-down
fact	concept=fact
data object	concept=fact
grain	concept=grain
hiearchy	concept=hierarchy
hierarchies	concept=hierarchy
information need	concept=question
measure	concept=measure
numeric	concept=numeric
numerical	concept=numeric
one-to-n	concept=oneN
one to one	concept=single
one-to-one	concept=single
question	concept=question
ask	concept=question
row	concept=row
single	concept=single
single value	concept=single
sum	concept=aggregate